11111111
10000001
100C0001
10000001
10E00C01
10000001
100C0001
10000001
1P000C01
11111111