11111111
10000001
10000001
10000001
10E00001
10000001
100C0001
1000P001
10000001
11111111