111111111111111111
100001000001CCC0C1
100101000000011101
1001010111110001C1
1001010100E1011101
10010001011101CC01
1P01000001C0010001
111111111111111111