111111111111111111
10000100R001CCC0C1
1001010000R0011101
1001010111110001C1
1001010100E1011101
10010001011101CC01
1P01000001C0010R01
111111111111111111